^^^''''''''''''''''''''''
^^''**''''''''''~~'''''''
^^''**''''''''~~'''''''''
^''''''''''''''''''''''''
'''~~~'''''''''''''''''''
'''~~~'''''''''''''''''''
'''~~~''''''''''^^'''''''
''''~~~'''''''^^^^'''''''
''''~~~'''''''^^^^'''''''
'''''~'''''''''''''''''''
'''''''''''''''''''''''''
