####################
#.................#
#.................#
#....######.......#
#.................#
#......#####......#
#.................#
####################