^^^''''''''''''''''''''''
^^''''''''''''''~~'''''''
^^''''''''''''''~~'''''''
^''''''''''''''''''''''''
'''~~~'''''''''''''''''''
'''~~~'''''''''''''''''''
'''~~~''''''''''^^'''''''
''''~~~'''''''^^^^'''''''
''''~~~'''''''^^^^'''''''
'''''~'''''''''''''''''''
'''''''''''''''''''''''''
